%%%%%%%%%%%
%        P%
%%%     %%%
%         %
%%%     %%%
%.        %
%%%%%%%%%%%